-
-
-
4,5,6,7,8,16,17,18,19,20
3,4,5,6,7,8,9,10,11,12,13,14,15,16,17,18,19,20,21
3,4,5,6,7,8,9,10,11,12,P1,13,14,15,16,17,18,19,20,21
3,4,5,6,7,8,9,10,11,12,13,14,15,16,17,18,19,20,21
3,4,5,6,7,8,9,10,11,12,13,14,15,16,17,18,19,20,21
4,5,6,7,8,9,10,11,12,13,14,15,16,17,18,19,20
5,6,7,8,9,15,16,17,18,19
-
5,6,7,8,9,15,16,17,18,19
4,5,6,7,8,9,10,11,12,13,14,15,16,17,18,19,20
3,4,5,6,7,8,9,10,11,12,13,14,15,16,17,18,19,20,21
3,4,5,6,7,8,9,10,11,12,13,14,15,16,17,18,19,20,21
3,4,5,6,7,8,9,10,11,12,P2,13,14,15,16,17,18,19,20,21
3,4,5,6,7,8,9,10,11,12,13,14,15,16,17,18,19,20,21
4,5,6,7,8,16,17,18,19,20


